  NO  ./textures/bricksheight.xpm
SO ./textures/bricksheight.xpm
WE ./textures/bricksheight.xpm
EA ./textures/bricksheight.xpm

F 200,100,0
C 100,100,20

1111111111
1000000001
1001110001
1000000001
1000000001
1011110001
1010011001
1N10000001
1111111111
