  NO  ./path_no
SO ./path_so
WE ./path_we
EA ./path_ea

F 200,100,0
C 100,100,20

1111111111
1000000001
10E0000011
1110000001
1000000001
1000111001
1000110001
1000100001
1000100001
1111111111
