  NO  ./textures/concrete2_seamless_diffuse_1k.xpm
SO ./textures/greenbubblescalesheight.xpm
WE ./textures/chocolatewaferstraw.xpm
EA ./textures/bricksheight.xpm

F 101,216,255
C 127,127  , 127

 1111111111
1000000001
10000E0011
111000000111
1000000000011
100011100111
 11000110001
1000100000001
100010000111
1111111111
