


        NO           ./path_no
   SO           ./path_so
WE ./path_we
 EA   ./path_ea

F   200,   100,500
C 100,0,  0




1111111111
10E0000011
1000000001
1000000001
1011000001
1011000001
1000000001
1111111111
