  NO  ./textures/greenbubblescalesheight.xpm
SO ./textures/concrete2_seamless_diffuse_1k.xpm
WE ./textures/bricksheight.xpm
EA ./textures/images.xpm

F 101, 216,     256 
C 127,127  , 255

111111111111111
1000000011
10000N00011
1110000011111
11111100001111
111011000000011
  100001001111111111111111
1111110001100000000000001
1000100000001111111111111
1000100001111
1111111111
