  NO  ./textures/concrete2_seamless_diffuse_1k.xpm
SO ./textures/greenbubblescalesheight.xpm
WE ./textures/chocolatewaferstraw.xpm
EA ./textures/bricksheight.xpm

F 200   ,100,0
C 100,100  ,   20

  1111111111
1000000001
10000E0011
111000000111
1000000000011
100011100111
  1000110001
100010000001
1000100001
1111111111
